WWWWWW
WWTWWW
WOBOOW
WOPOXW
WWWWWW