WWWWWW
WWOOOWW
WWOOOWW
WPBBBBOW
WOTTTTOW
WWOOOWWW
WWWWWWWW