WWWWWWWW
WWWOOOWW
WWOOWOWW
WWBTTBWW
WOTBBTWW
WOBTTBOW
WWOWOOOW
WWPOOWWW
WWWWWWWW