WWWWWW
WWTWWW
WOBOOW
WOOOXW
WOPOOW
WWWWWW