WWWWWW
WWTWWW
WOBOOW
WOPOOW
WWWWWW