WWWWWW
WWTWWW
WOBOOW
WOOOXW
WOOOPW
WWWWWW